# メインの対照表。
# 以下は複数の既存の対照表を参考にして個人の主観で妥当そうな変換をしている文字の組を抽出したリスト。
変換前	変換後
丑	醜
专	専
业	業
丛	叢
东	東
丝	絲
两	両
严	厳
丧	喪
个	個
丰	豊
临	臨
为	為
丽	麗
举	挙
么	麼
义	義
乌	烏
乐	楽
乔	喬
乘	乗
习	習
乡	郷
书	書
买	買
亏	虧
云	雲
亚	亜
产	産
亩	畝
亲	親
亿	億
仅	僅
仆	僕
从	従
仑	侖
仓	倉
仞	仭
仪	儀
们	們
价	価
仿	倣
众	衆
优	優
伛	傴
伞	傘
伟	偉
传	伝
伤	傷
伦	倫
伪	偽
伫	佇
佛	仏
佣	傭
佥	僉
侄	姪
侣	侶
侥	僥
侦	偵
侧	側
侨	僑
侪	儕
俊	儁
俞	兪
俦	儔
俨	厳
俩	倆
俭	倹
俭	儉
俱	倶
债	債
值	値
倾	傾
假	仮
偷	偸
偻	僂
偿	償
傥	儻
储	儲
傩	儺
儿	児
兑	兌
兔	兎
兰	蘭
关	関
兴	興
兹	茲
养	養
兽	獣
冈	岡
册	冊
军	軍
农	農
冢	塚
冯	馮
冰	氷
冱	沍
冲	衝
决	決
况	況
冻	凍
净	浄
准	準
凉	涼
减	減
凑	湊
几	幾
凤	鳳
凫	鳧
凭	憑
凯	凱
击	撃
凿	鑿
刍	芻
划	劃
刘	劉
则	則
刚	剛
创	創
删	刪
别	別
刭	剄
剀	剴
剂	剤
剑	剣
剧	劇
剩	剰
剿	勦
劝	勧
务	務
动	動
劲	勁
劳	労
势	勢
勋	勲
勖	勗
匮	匱
卅	丗
升	昇
华	華
协	協
单	単
卖	売
卢	盧
卤	鹵
卧	臥
卫	衛
卷	巻
厂	廠
厅	庁
历	暦
压	圧
厌	厭
厕	廁
厢	廂
厦	廈
厮	廝
县	県
县	縣
发	発
变	変
叠	畳
叹	嘆
吕	呂
吞	呑
吨	噸
听	聴
启	啓
吴	呉
呐	吶
呒	嘸
呓	囈
呕	嘔
呗	唄
员	員
呜	嗚
咏	詠
咒	呪
咛	嚀
咨	諮
咸	鹹
咽	嚥
响	響
哑	唖
哗	譁
唤	喚
唧	喞
啧	嘖
啬	嗇
啭	囀
啮	噛
啸	嘯
喷	噴
喻	喩
嗫	囁
嘤	嚶
噪	譟
嚣	囂
囊	嚢
团	団
园	園
围	囲
图	図
圆	円
圈	圏
圣	聖
圹	壙
场	場
址	阯
坏	壊
块	塊
坚	堅
坛	壇
坞	塢
坟	墳
坠	墜
垄	壟
垒	塁
垦	墾
埘	塒
埚	堝
堇	菫
堑	塹
墙	墻
增	増
壤	壌
壳	殻
壶	壺
壹	壱
处	処
备	備
复	復
头	頭
夸	誇
夹	夾
夺	奪
奁	匳
奂	奐
奋	奮
奖	奨
妆	粧
妇	婦
妈	媽
妒	妬
妪	嫗
姊	姉
姜	薑
姬	姫
娄	婁
娇	嬌
娱	娯
娴	嫺
婴	嬰
媪	媼
嫔	嬪
孙	孫
宁	寧
实	実
宠	寵
审	審
宪	憲
宽	寛
宾	賓
对	対
寻	尋
导	導
尔	爾
尘	塵
尝	嘗
尧	尭
层	層
屿	嶼
岁	歳
岂	豈
岗	崗
岚	嵐
岛	島
岭	嶺
峥	崢
峦	巒
崭	嶄
巅	巓
巢	巣
巩	鞏
币	幣
帅	帥
师	師
帏	幃
帐	帳
帘	簾
帚	箒
帜	幟
带	帯
帧	幀
帮	幇
幂	冪
并	並
广	広
庄	荘
庆	慶
庐	廬
库	庫
应	応
庙	廟
庞	厖
废	廃
廪	廩
开	開
异	異
弃	棄
张	張
弹	弾
强	強
归	帰
录	録
彻	徹
德	徳
忆	憶
忏	懺
忧	憂
忾	愾
怀	懐
态	態
怂	慫
怃	憮
怅	悵
怆	愴
怜	憐
总	総
怿	懌
恳	懇
恶	悪
恸	慟
恻	惻
恼	悩
悬	懸
悭	慳
悯	憫
惊	驚
惠	恵
惧	懼
惩	懲
惭	慚
惮	憚
惯	慣
愈	癒
愤	憤
愿	願
慑	懾
懑	懣
懒	懶
懔	懍
懵	儚
戏	戯
战	戦
戛	戞
户	戸
戾	戻
扑	撲
托	託
扣	釦
执	執
扩	拡
扪	捫
扫	掃
扬	揚
扰	擾
抚	撫
抟	摶
抢	搶
护	護
报	報
拂	払
拔	抜
拜	拝
拟	擬
拣	揀
拥	擁
拨	撥
择	択
挚	摯
挛	攣
挞	撻
挠	撓
挤	擠
挥	揮
捆	梱
捞	撈
损	損
换	換
捣	搗
据	拠
掷	擲
插	挿
揭	掲
揽	攬
搁	擱
搅	撹
搔	掻
搜	捜
摄	摂
摆	擺
摇	揺
摈	擯
摊	攤
擀	扞
攒	攅
收	収
效	効
敌	敵
敕	勅
斋	斎
斗	闘
斩	斬
旁	傍
无	無
时	時
旷	曠
昙	曇
显	顕
晓	暁
晔	曄
晕	暈
晖	暉
晚	晩
暂	暫
暧	曖
暨	曁
曳	曵
曾	曽
术	術
朵	朶
机	機
杀	殺
杂	雑
权	権
杆	桿
杨	楊
杰	傑
极	極
构	構
枞	樅
枣	棗
枥	櫪
枪	槍
枫	楓
枭	梟
柠	檸
查	査
栀	梔
栅	柵
标	標
栈	桟
栋	棟
栌	櫨
栎	檪
栏	欄
树	樹
样	様
桠	椏
桡	橈
桤	榿
桥	橋
桧	檜
桴	枹
梦	夢
检	検
棱	稜
棹	櫂
椁	槨
椠	槧
椭	橢
榄	欖
榆	楡
榈	櫚
榉	欅
榨	搾
槛	檻
槟	檳
樯	檣
樱	桜
橹	櫓
橼	櫞
檐	簷
欢	歓
欤	歟
步	歩
歼	殲
殇	殤
殒	殞
殚	殫
殡	殯
毁	毀
毂	轂
毕	畢
毗	毘
毙	斃
毡	氈
气	気
氛	雰
汇	匯
汉	漢
污	汚
汤	湯
汹	洶
沉	沈
沟	溝
沥	瀝
沦	淪
沧	滄
沪	滬
沾	霑
泄	洩
泞	濘
泪	涙
泷	滝
泸	瀘
泻	瀉
泼	溌
泽	沢
洁	潔
洼	窪
浃	浹
浆	漿
浇	澆
浊	濁
测	測
济	済
浏	瀏
浑	渾
浒	滸
浓	濃
浔	潯
浚	濬
涂	塗
涉	渉
涌	湧
涛	濤
涟	漣
涡	渦
涣	渙
涤	滌
润	潤
涧	澗
涨	漲
涩	渋
淀	澱
渊	淵
渍	漬
渎	涜
渐	漸
渔	漁
渗	滲
游	遊
溃	潰
溅	濺
溉	漑
溪	渓
溯	遡
滚	滾
满	満
滤	濾
滥	濫
滨	浜
滩	灘
潇	瀟
潋	瀲
潴	瀦
澜	瀾
濑	瀬
濒	瀕
灭	滅
灵	霊
灶	竃
灾	災
灿	燦
炀	煬
炖	燉
炫	衒
炮	砲
炯	烱
炼	煉
炽	熾
烁	爍
烂	爛
烛	燭
烟	煙
烦	煩
烧	焼
烬	燼
热	熱
焕	煥
焰	焔
熏	燻
爱	愛
爷	爺
牍	牘
牵	牽
牺	犠
犊	犢
犹	猶
狈	狽
狞	獰
狮	獅
狯	獪
狱	獄
猎	猟
猬	蝟
獭	獺
玛	瑪
环	環
现	現
玺	璽
珐	琺
珑	瓏
珲	琿
琐	瑣
琼	瓊
璎	瓔
瓮	甕
电	電
畅	暢
畴	疇
疏	疎
疗	療
疟	瘧
疡	瘍
疣	肬
疮	瘡
疯	瘋
疱	皰
痈	癰
痉	痙
痒	癢
痨	癆
痫	癇
瘘	瘻
瘦	痩
癞	癩
癣	癬
癫	癲
皋	皐
皑	皚
皱	皺
皲	皸
盏	盞
盐	塩
监	監
盖	蓋
盘	盤
睑	瞼
睹	覩
睿	叡
瞒	瞞
矫	矯
矾	礬
矿	鉱
码	碼
砖	磚
砚	硯
砺	礪
砾	礫
础	礎
硕	碩
硗	磽
确	確
硷	鹸
碍	礙
碎	砕
碛	磧
磷	燐
祯	禎
祸	禍
禀	稟
离	離
秃	禿
秆	稈
种	種
秕	粃
积	積
秽	穢
稳	穏
稻	稲
穑	穡
穗	穂
穰	穣
穷	窮
窍	竅
窑	窯
窗	窓
窜	竄
窝	窩
窥	窺
窦	竇
窭	窶
竖	竪
竞	競
笃	篤
笋	筍
笔	筆
笕	筧
笺	牋
笼	籠
筚	篳
筛	篩
筝	箏
筱	篠
筹	籌
签	籖
简	簡
箦	簀
箧	篋
箫	簫
篑	簣
篓	簍
篡	簒
篮	籃
篮	藍
篱	籬
籁	籟
籴	糴
类	類
粜	糶
粪	糞
粮	糧
粹	粋
紧	緊
纠	糾
纡	紆
红	紅
纣	紂
纤	繊
约	約
级	級
纪	紀
纬	緯
纭	紜
纯	純
纰	紕
纱	紗
纲	綱
纳	納
纵	縦
纶	綸
纷	紛
纸	紙
纹	紋
纺	紡
纽	紐
线	線
绀	紺
绁	紲
练	練
组	組
绅	紳
细	細
织	織
终	終
绊	絆
绍	紹
绎	繹
经	経
绐	紿
绒	絨
结	結
绕	繞
绗	絎
绘	絵
给	給
绚	絢
络	絡
绝	絶
绞	絞
统	統
绢	絹
绣	繍
绥	綏
继	継
绩	績
绪	緒
绫	綾
续	続
绮	綺
绯	緋
绰	綽
绳	縄
维	維
绵	綿
绶	綬
绷	繃
绸	綢
绻	綣
综	綜
绽	綻
绾	綰
绿	緑
缀	綴
缁	緇
缄	緘
缅	緬
缆	纜
缉	緝
缎	緞
缒	縋
缓	緩
缔	締
缕	縷
编	編
缗	緡
缘	縁
缙	縉
缚	縛
缛	縟
缝	縫
缟	縞
缠	纏
缢	縊
缤	繽
缥	縹
缦	縵
缧	縲
缨	纓
缩	縮
缪	繆
缬	纈
缭	繚
缮	繕
缲	繰
缵	纉
罂	罌
罐	缶
网	網
罗	羅
罚	罰
罢	罷
羁	羈
羡	羨
羹	羮
翘	翹
耸	聳
耻	恥
聂	聶
聋	聾
职	職
聍	聹
联	聯
聪	聡
聪	聰
肃	粛
肠	腸
肤	膚
肾	腎
肿	腫
胀	脹
胁	脇
胜	勝
胪	臚
胫	脛
胭	臙
胶	膠
脉	脈
脍	膾
脏	臓
脐	臍
脑	脳
脓	膿
脔	臠
脸	臉
腮	顋
腻	膩
腽	膃
腾	騰
膻	羶
舄	潟
舆	輿
舍	舎
舣	艤
舰	艦
舱	艙
艰	艱
艳	艶
艺	芸
节	節
芜	蕪
芦	蘆
苇	葦
苍	蒼
苎	苧
苏	蘇
苹	蘋
范	範
茏	蘢
茑	蔦
茔	塋
茕	煢
茧	繭
荆	荊
荐	薦
荔	茘
荚	莢
荛	蕘
荞	蕎
荟	薈
荠	薺
荡	蕩
荣	栄
荤	葷
荨	蕁
荫	蔭
药	薬
莓	苺
莲	蓮
莳	蒔
莴	萵
获	獲
莹	瑩
莺	鶯
莼	蓴
萝	蘿
萤	蛍
营	営
萧	蕭
萨	薩
萼	蕚
蒂	蔕
蒙	矇
蓝	藍
蓟	薊
蓦	驀
蔷	薔
蔺	藺
蔼	藹
蕴	蘊
薯	藷
薰	薫
藏	蔵
藓	蘚
虏	虜
虑	慮
虽	雖
蚀	蝕
蚁	蟻
蚬	蜆
蛊	蠱
蛎	蠣
蛰	蟄
蛲	蟯
蜕	蛻
蜗	蝸
蜡	蝋
蝇	蝿
蝎	蠍
蝼	螻
蝾	蠑
蠢	惷
蠹	蠧
衅	釁
衔	銜
补	補
衬	襯
衮	袞
衽	袵
袅	嫋
袜	襪
袭	襲
裆	襠
裤	袴
褛	褸
褴	襤
见	見
观	観
规	規
觅	覓
视	視
览	覧
觉	覚
觊	覬
觋	覡
觌	覿
觏	覯
觐	覲
觞	觴
誊	謄
计	計
订	訂
讣	訃
认	認
讥	譏
讦	訐
讨	討
让	譲
讫	訖
训	訓
议	議
讯	訊
记	記
讲	講
讳	諱
讴	謳
讶	訝
讷	訥
许	許
讹	訛
论	論
讼	訟
讽	諷
设	設
访	訪
诀	訣
证	証
诂	詁
诃	訶
评	評
诅	詛
识	識
诈	詐
诉	訴
诊	診
诋	詆
词	詞
诏	詔
译	訳
诒	詒
诔	誄
试	試
诗	詩
诘	詰
诙	詼
诚	誠
诛	誅
话	話
诞	誕
诟	詬
诠	詮
诡	詭
询	詢
诣	詣
诤	諍
该	該
详	詳
诧	詫
诨	諢
诫	誡
诬	誣
语	語
诮	誚
误	誤
诰	誥
诱	誘
诲	誨
诳	誑
说	説
诵	誦
请	請
诸	諸
诹	諏
诺	諾
读	読
诽	誹
课	課
谀	諛
谁	誰
调	調
谄	諂
谅	諒
谆	諄
谈	談
谊	誼
谋	謀
谍	諜
谏	諫
谐	諧
谑	謔
谒	謁
谓	謂
谔	諤
谕	諭
谗	讒
谘	諮
谙	諳
谚	諺
谛	諦
谜	謎
谝	諞
谟	謨
谡	謖
谢	謝
谣	謡
谤	謗
谥	謚
谦	謙
谧	謐
谨	謹
谩	謾
谪	謫
谬	謬
谭	譚
谮	譖
谱	譜
谴	譴
谵	譫
谶	讖
豺	犲
貘	獏
贝	貝
贞	貞
负	負
贡	貢
财	財
责	責
贤	賢
败	敗
货	貨
质	質
贩	販
贪	貪
贫	貧
贬	貶
购	購
贮	貯
贯	貫
贰	弐
贱	賤
贲	賁
贳	貰
贴	貼
贵	貴
贷	貸
贸	貿
费	費
贺	賀
贻	貽
贼	賊
贽	贄
贾	賈
贿	賄
赀	貲
赁	賃
赂	賂
资	資
赆	贐
赈	賑
赉	賚
赋	賦
赌	賭
赍	齎
赎	贖
赏	賞
赐	賜
赔	賠
赖	頼
赘	贅
赙	賻
赚	賺
赛	賽
赝	贋
赞	讃
赞	賛
赠	贈
赡	贍
赢	贏
赵	趙
趋	趨
跃	躍
跄	蹌
踌	躊
踪	蹤
踬	躓
踯	躑
蹑	躡
蹒	蹣
躏	躙
躲	躱
车	車
轧	軋
轨	軌
轩	軒
转	転
轭	軛
轮	輪
软	軟
轰	轟
轲	軻
轳	轤
轴	軸
轶	軼
轸	軫
轹	轢
轻	軽
轼	軾
载	載
轾	輊
轿	轎
较	較
辄	輒
辅	輔
辆	輛
辇	輦
辈	輩
辉	輝
辍	輟
辎	輜
辏	輳
辐	輻
辑	輯
输	輸
辔	轡
辕	轅
辖	轄
辗	輾
辘	轆
辙	轍
辟	闢
辨	辧
辩	辯
辫	辮
边	辺
辽	遼
达	達
迁	遷
过	過
迈	邁
运	運
还	還
这	這
进	進
远	遠
违	違
连	連
迟	遅
迹	跡
适	適
选	選
逊	遜
递	逓
逻	邏
遁	遯
遒	逎
遗	遺
邮	郵
邹	鄒
邻	隣
郁	鬱
郑	鄭
郸	鄲
酱	醤
酿	醸
醉	酔
采	採
释	釈
鉴	鑑
銮	鑾
錾	鏨
针	針
钉	釘
钏	釧
钓	釣
钗	釵
钝	鈍
钞	鈔
钟	鐘
钢	鋼
钣	鈑
钦	欽
钧	鈞
钩	鈎
钮	鈕
钱	銭
钲	鉦
钳	鉗
钵	鉢
钺	鉞
钻	鑽
钿	鈿
铁	鉄
铃	鈴
铄	鑠
铅	鉛
铉	鉉
铊	鉈
铎	鐸
铗	鋏
铙	鐃
铛	鐺
铜	銅
铠	鎧
铢	銖
铣	銑
铨	銓
铫	銚
铭	銘
铮	錚
铰	餃
铳	銃
银	銀
铸	鋳
铺	舗
铿	鏗
销	銷
锁	鎖
锄	鋤
锅	鍋
锈	銹
锋	鋒
锍	鉚
锐	鋭
锖	錆
错	錯
锚	錨
锡	錫
锢	錮
锣	鑼
锤	錘
锥	錐
锦	錦
锭	錠
键	鍵
锯	鋸
锵	鏘
锷	鍔
锹	鍬
锻	鍛
镀	鍍
镂	鏤
镇	鎮
镊	鑷
镌	鐫
镐	鎬
镒	鎰
镘	鏝
镜	鏡
镝	鏑
镞	鏃
镡	鐔
镣	鐐
镦	鐓
镫	鐙
镰	鎌
长	長
门	門
闩	閂
闪	閃
闭	閉
问	問
闯	闖
闰	閏
闲	閑
间	間
闵	閔
闷	悶
闸	閘
闹	鬧
闺	閨
闻	聞
闼	闥
闾	閭
阀	閥
阁	閣
阄	鬮
阅	閲
阈	閾
阉	閹
阋	鬩
阎	閻
阏	閼
阐	闡
阑	闌
阒	闃
阔	闊
阖	闔
阙	闕
队	隊
阱	穽
阳	陽
阴	陰
阵	陣
阶	階
际	際
陆	陸
陇	隴
陈	陳
陕	陜
陨	隕
险	険
陷	陥
随	隨
隐	隠
隶	隷
隽	雋
难	難
雏	雛
雕	彫
雠	讎
雳	靂
雾	霧
霁	霽
霉	黴
霭	靄
霸	覇
靠	磑
靥	靨
鞑	韃
韦	韋
韩	韓
韬	韜
韭	韮
韵	韻
页	頁
顶	頂
顷	頃
项	項
顺	順
须	須
顽	頑
顾	顧
顿	頓
颁	頒
颂	頌
颃	頏
预	預
颅	顱
领	領
颇	頗
颈	頸
颉	頡
颊	頬
颍	潁
颐	頤
频	頻
颓	頽
颔	頷
颖	穎
题	題
颜	顔
额	額
颞	顳
颠	顛
颤	顫
颦	顰
颧	顴
风	風
飒	颯
飓	颶
飘	飄
飙	飆
飞	飛
飨	饗
饥	飢
饨	飩
饬	飭
饭	飯
饮	飲
饯	餞
饰	飾
饱	飽
饲	飼
饴	飴
饵	餌
饶	饒
饷	餉
饼	餅
饿	餓
馀	餘
馁	餒
馅	餡
馆	館
馈	饋
馏	餾
馑	饉
馒	饅
馔	饌
马	馬
驭	馭
驮	駄
驯	馴
驰	馳
驱	駆
驳	駁
驴	驢
驶	駛
驷	駟
驹	駒
驻	駐
驼	駝
驽	駑
驾	駕
驿	駅
骀	駘
骁	驍
骂	罵
骄	驕
骆	駱
骇	駭
骈	駢
骋	騁
验	験
骏	駿
骐	騏
骓	騅
骖	驂
骗	騙
骚	騒
骛	鶩
骞	騫
骠	驃
骡	騾
骤	驟
骥	驥
髅	髏
髓	髄
鬓	鬢
魇	魘
魉	魎
鱼	魚
鲁	魯
鲂	魴
鲆	鮃
鲇	鮎
鲈	鱸
鲋	鮒
鲍	鮑
鲑	鮭
鲔	鮪
鲛	鮫
鲜	鮮
鲣	鰹
鲤	鯉
鲧	鯀
鲨	鯊
鲭	鯖
鲱	鯡
鲲	鯤
鲵	鯢
鲶	鯰
鲷	鯛
鲸	鯨
鲻	鯔
鲽	鰈
鳃	鰓
鳄	鰐
鳅	鰍
鳆	鰒
鳇	鰉
鳌	鰲
鳍	鰭
鳏	鰥
鳔	鰾
鳕	鱈
鳖	鼈
鳗	鰻
鳞	鱗
鳟	鱒
鸟	鳥
鸠	鳩
鸡	鶏
鸢	鳶
鸣	鳴
鸥	鴎
鸦	鴉
鸨	鴇
鸩	鴆
鸪	鴣
鸫	鶇
鸭	鴨
鸯	鴦
鸱	鴟
鸳	鴛
鸵	鴕
鸷	鷙
鸽	鴿
鸾	鸞
鸿	鴻
鹃	鵑
鹄	鵠
鹅	鵝
鹉	鵡
鹊	鵲
鹎	鵯
鹏	鵬
鹑	鶉
鹗	鶚
鹞	鷂
鹤	鶴
鹦	鸚
鹧	鷓
鹩	鷯
鹪	鷦
鹫	鷲
鹬	鷸
鹭	鷺
鹰	鷹
鹳	鸛
麇	麕
麸	麩
黉	黌
黑	黒
默	黙
黩	黷
黾	黽
齐	斉
齑	齏
齿	歯
龀	齔
龃	齟
龄	齢
龆	齠
龈	齦
龉	齬
龊	齪
龋	齲
龌	齷
龙	龍
龛	龕
龟	亀
